111111
100*01
1PCEJ1
10*111
111111