111111
100001
1PCE01
100111
111111