111111
1PCE01
100111
100001
100001
111111